                                 
                                 
             #   #              
             #   #              
             #   #              
             #   #              
             #   #              
             #   #              
             #   #              
             #   #              
             #   #              
          ####   ####              
          #         #             
          # ##   ## #              
  ######### #     # ##########   
                                 
                                 
  ######### #     # ##########   
          # ##   ## #             
          #         #            
          ####   ####               
             #   #              
             #   #              
             #   #              
             #   #              
             #   #              
             #   #              
             #   #              
             #   #              
             #   #              
                                 
                                  